3
13
31
###############################
#p   ** ** 2  *   2           #
# # # #*# # # # # # # # # # # #
#*     ** * *  *   * ** 2 *   #
# # # # # #*# # # # # # #*# # #
#*   *s* 1  *** * x **        #
# # # # # # # # # # # # # #*# #
#    *     *        *    **  2#
# #*# # #*#*#*#*# # #1# # #*# #
#        *   *2*    *   *     #
#*# # # # # # # # # # #*# # #*#
# *    * **  2 ** ***     1   #
###############################