5
13
31
###############################
#p * *2       *  ** * *  2   *#
# # # # #*# # #*# # # # # #*# #
#    * * *** **  2   *    **  #
# #*# # # # #2# #b#1# # # # #*#
#        2 *     **      *  **#
# # #*# # # # # #*#*#*#*# # # #
#   *        *   * *x* *   2  #
# # # # #*# # # # # # #*# #*# #
#   ****      1  *2           #
# # # # # # # # # #*# # # # #*#
#  ** *2  *    2      2  2    #
###############################